33333333000033333333
00000000000000000000
00002222222222220000
00000000000000000000
11111111000011111111
00000000000000000000
00002222222222220000
00000000000000000000
33333333000033333333
