33330000000000003333
02222000000000022220
00111100000000111100
00033330000003333000
00002222000022220000
00000111100111100000
00003333000033330000
00022220000002222000
00111100000000111100