33333333333333333333
22222222222222222222
11111111111111111111
33330000333300003333
22220000222200002222
11110000111100001111
00003333333333330000
00002222222222220000
00001111111111110000